WWWWWWWW
WCCCCCCW
WCWCWWCW
WCWWWWCW
WCWCCCCW
WCWCWWCW
WCWCCCCW
WCCCWWWW
WWWWWWWW